../flamingo.fla	../swfs/flamingo.swf	
../fmc/Authentication.fla	../swfs/fmc/Authentication.swf
../fmc/BaseContainer.fla	../swfs/fmc/BaseContainer.swf
../fmc/BitmapClone.fla	../swfs/fmc/BitmapClone.swf
../fmc/CommitButton.fla	../swfs/fmc/CommitButton.swf
../fmc/Confirmation.fla	../swfs/fmc/Confirmation.swf
../fmc/Cursors.fla	../swfs/fmc/Cursors.swf
../fmc/DownloadSelector.fla	../swfs/fmc/DownloadSelector.swf
../fmc/DownloadSelectorButton.fla	../swfs/fmc/DownloadSelectorButton.swf
../fmc/EditBar.fla	../swfs/fmc/EditBar.swf
../fmc/EditLegend.fla	../swfs/fmc/EditLegend.swf
../fmc/EditMap.fla	../swfs/fmc/EditMap.swf
../fmc/EditLegend.fla	../swfs/fmc/EditLegend.swf
../fmc/EditBar.fla	../swfs/fmc/EditBar.swf
../fmc/EditLegend.fla	../swfs/fmc/EditLegend.swf
../fmc/EditMap.fla	../swfs/fmc/EditMap.swf
../fmc/EditProperties.fla	../swfs/fmc/EditProperties.swf
../fmc/GIS.fla	../swfs/fmc/GIS.swf
../fmc/LayerProxy.fla	../swfs/fmc/LayerProxy.swf
../fmc/MapProxy.fla	../swfs/fmc/MapProxy.swf
../fmc/Print.fla	../swfs/fmc/Print.swf
../fmc/PrintButton.fla	../swfs/fmc/PrintButton.swf
../fmc/PrintLabel.fla	../swfs/fmc/PrintLabel.swf
../fmc/PrintTemplate.fla	../swfs/fmc/PrintTemplate.swf
../fmc/RemoteEventDispatcher.fla	../swfs/fmc/RemoteEventDispatcher.swf
../fmc/RemoveFeatureButton.fla	../swfs/fmc/RemoveFeatureButton.swf
../fmc/ScalableContainer.fla	../swfs/fmc/ScalableContainer.swf
../tpc/SubsidieInfoPB.fla	../swfs/tpc/SubsidieInfoPB.swf
../fmc/Veil.fla	../swfs/fmc/Veil.swf
../fmc/BorderNavigation.fla	../swfs/fmc/BorderNavigation.swf
../fmc/ButtonFull.fla	../swfs/fmc/ButtonFull.swf
../fmc/ButtonNext.fla	../swfs/fmc/ButtonNext.swf
../fmc/ButtonPrev.fla	../swfs/fmc/ButtonPrev.swf
../fmc/Container.fla	../swfs/fmc/Container.swf
../fmc/Coordinates.fla	../swfs/fmc/Coordinates.swf
../fmc/CursorsMap.fla	../swfs/fmc/CursorsMap.swf
../fmc/CursorsWindow.fla	../swfs/fmc/CursorsWindow.swf
../fmc/Debugger.fla	../swfs/fmc/Debugger.swf
../fmc/IdentifyResults.fla	../swfs/fmc/IdentifyResults.swf
../fmc/IdentifyResultsHTML.fla	../swfs/fmc/IdentifyResultsHTML.swf
../fmc/Image.fla	../swfs/fmc/Image.swf
../fmc/LanguagePicker.fla	../swfs/fmc/LanguagePicker.swf
../fmc/LayerArcIMS.fla	../swfs/fmc/LayerArcIMS.swf
../fmc/LayerGrid.fla	../swfs/fmc/LayerGrid.swf
../fmc/LayerIdentifyIcon.fla	../swfs/fmc/LayerIdentifyIcon.swf
../fmc/LayerImage.fla	../swfs/fmc/LayerImage.swf
../fmc/LayerOGWMS.fla	../swfs/fmc/LayerOGWMS.swf
../fmc/LayerOverview.fla	../swfs/fmc/LayerOverview.swf
../fmc/Legend.fla	../swfs/fmc/Legend.swf
../fmc/LocationFinder.fla	../swfs/fmc/LocationFinder.swf
../fmc/Logo.fla	../swfs/fmc/Logo.swf
../fmc/LogoRiscMap.fla	../swfs/fmc/LogoRiscMap.swf
../fmc/Map.fla	../swfs/fmc/Map.swf
../fmc/Maptip.fla	../swfs/fmc/Maptip.swf
../fmc/MonitorLayer.fla	../swfs/fmc/MonitorLayer.swf
../fmc/MonitorMap.fla	../swfs/fmc/MonitorMap.swf
../fmc/NamedExtentViewer.fla	../swfs/fmc/NamedExtentViewer.swf
../fmc/Scalebar.fla	../swfs/fmc/Scalebar.swf
../fmc/Text.fla	../swfs/fmc/Text.swf
../fmc/TextArea.fla	../swfs/fmc/TextArea.swf
../fmc/ToolGroup.fla	../swfs/fmc/ToolGroup.swf
../fmc/ToolIdentify.fla	../swfs/fmc/ToolIdentify.swf
../fmc/ToolMeasure.fla	../swfs/fmc/ToolMeasure.swf
../fmc/ToolPan.fla	../swfs/fmc/ToolPan.swf
../fmc/ToolSuperPan.fla	../swfs/fmc/ToolSuperPan.swf
../fmc/ToolZoomin.fla	../swfs/fmc/ToolZoomin.swf
../fmc/ToolZoomOut.fla	../swfs/fmc/ToolZoomOut.swf
../fmc/Window.fla	../swfs/fmc/Window.swf
../fmc/ZoomerV.fla	../swfs/fmc/ZoomerV.swf